0000000000
0000000000
0003333300
0033040330
0030444030
0033444030
0003000330
0003330300
0000033300
0000000000