1003333330
0033033330
0003333330
0333333303
0333333000
0300003000
0303333000
0300000000
0000000000
0000000000