0333333001
0300003000
0303333033
0000003000
0303003330
0303000030
0303000330
0003000000
0303303330
0302333300