0333333001
0300043000
0303333033
0040003000
0303003330
0303000030
0303040330
0003000000
0303303330
4302333400