1000400000
0033333400
0000000030
4030430030
0030030034
0030030000
0030030330
3400000430
3333303330
3333340002