3330300040
0004003030
0033003030
0330003030
0300333030
4303304000
0340003303
0330033003
0333330033
2333330001