1000000000
0330303330
0003303000
0303303030
0300033030
0303333030
0303200030
0333333330
0033330300
0000000000