10300000000
0300000000
2300000000
3300000000
0000000000
0000000000
0000000000
0000000000
0000000000
0000000000