1000000033
0000000003
0000003400
0000300300
0004330000
0000333000
3333333000
0000333000
0004004000
0000000002