0000400000
0000330000
0333300030
0300334430
3003033030
3000030030
3003000030
0300000000
0333333300
0000000000