1000000000
0333033330
0003000330
0303333330
0300030000
0303330330
0303030330
0333030230
0333033330
0000000000